# Syntax colouring map for CRSF for Arduino.

# Namespaces (KEYWORD1)
crsfProtocol	KEYWORD1
hal	KEYWORD1
genericStreamBuffer	KEYWORD1
serialReceiver	KEYWORD1
sketchLayer	KEYWORD1

# Datatypes (KEYWORD1)
CRSF_DEBUG_SERIAL_PORT	KEYWORD1
crsf	KEYWORD1
CRSFforArduino	KEYWORD1

# Functions (KEYWORD2)
begin	KEYWORD2
end	KEYWORD2
getChannel	KEYWORD2
rcToUs	KEYWORD2
readRcChannel	KEYWORD2
telemetryWriteAttitude	KEYWORD2
telemetryWriteBaroAltitude	KEYWORD2
telemetryWriteBattery	KEYWORD2
telemetryWriteGPS	KEYWORD2
update	KEYWORD2

# Structures (KEYWORD3)

# Constants (LITERAL1)
BAUD_RATE	LITERAL1
CRSFFORARDUINO_VERSION	LITERAL1
CRSFFORARDUINO_VERSION_DATE	LITERAL1
CRSFFORARDUINO_VERSION_MAJOR	LITERAL1
CRSFFORARDUINO_VERSION_MINOR	LITERAL1
CRSFFORARDUINO_VERSION_PATCH	LITERAL1
CRSF_RC_ENABLED	LITERAL1
CRSF_RC_MAX_CHANNELS	LITERAL1
CRSF_RC_MAX_CHANNELS	LITERAL1
CRSF_RC_CHANNEL_MAX	LITERAL1
CRSF_RC_CHANNEL_CENTER	LITERAL1
CRSF_RC_INITIALISE_CHANNELS	LITERAL1
CRSF_RC_INITIALISE_THROTTLECHANNEL	LITERAL1
CRSF_TELEMETRY_ENABLED	LITERAL1
CRSF_TELEMETRY_ATTITUDE_ENABLED	LITERAL1
CRSF_TELEMETRY_BAROALTITUDE_ENABLED	LITERAL1
CRSF_TELEMETRY_BATTERY_ENABLED	LITERAL1
CRSF_TELEMETRY_GPS_ENABLED	LITERAL1
CRSF_DEBUG_ENABLED	LITERAL1
RC_CHANNEL_ROLL	LITERAL1
RC_CHANNEL_PITCH	LITERAL1
RC_CHANNEL_THROTTLE	LITERAL1
RC_CHANNEL_YAW	LITERAL1
RC_CHANNEL_AUX1	LITERAL1
RC_CHANNEL_AUX2	LITERAL1
RC_CHANNEL_AUX3	LITERAL1
RC_CHANNEL_AUX4	LITERAL1
RC_CHANNEL_AUX5	LITERAL1
RC_CHANNEL_AUX6	LITERAL1
RC_CHANNEL_AUX7	LITERAL1
RC_CHANNEL_AUX8	LITERAL1
RC_CHANNEL_AUX9	LITERAL1
RC_CHANNEL_AUX10	LITERAL1
RC_CHANNEL_AUX11	LITERAL1
RC_CHANNEL_AUX12	LITERAL1
RC_CHANNEL_COUNT	LITERAL1
